R 640 480 
NO ./images/no.xpm
SO ./images/so.xpm
WE ./images/we.xpm
EA ./images/ea.xpm

S ./path_to_the_sprite_texture
F 32,32,32
C 153,204,255

         11111111111111111111111
        1000000000110000000000001 
        1011000001110000000000001
        1001000000000000000000001
111111111011000001110000000000001  
100000000011000001110111111111111 
11110111111111111101110000001
11110111111111011101010010001
11000000110101011100000010001
10002000000000000000000010001
10000000000000001101010010001
11000001110101011111011110N0111
11110111 1110101 101111010001
11111111 1111111 111111111111
